XXXXXXXXXXXXXXXXXXXXXXX
X                c    X
X h        f          X
X       d             X
X          c          X
X                     X
X                     X
X                     X
X        d            X
X      d     A        X
X              b      X
X       b             X
X                     X
X               d     X
X                     X
X        c        a   X
X                     X
X    a                X
X a           a       X
X                     X
X                     X
X         a           X
XXXXXXXXXXXXXXXXXXXXXXX
