+---------+
|A: | : :B|
| : | : : |
| : : : : |
| | : | : |
|C| : |D: |
+---------+
