XXXXXXXXXXXXXXXXXXXXXXX
X                c    X
X          f          X
X   e                 X
X          c     e    X
X                     X
X                     X
X                     X
X      f              X
X   e     b           X
X                b    X
X            A        X
X        b       f    X
X     a               X
X                     X
X        c        a   X
X                     X
X    a           e    X
X a           a       X
X                     X
X   c                 X
X         a           X
XXXXXXXXXXXXXXXXXXXXXXX
